h110101111
1110101001
1000101001
1111101111
0000100001
1010b11101
1010s00101
1111100101
1000111101
111s100101
