1111111111
1000100001
1000100001
1111111111
1010100101
1010100101
1010100101
1010100101
1010100101
1111111111