h111111111
1000100001
1000100001
s111b1111s
1010100101
1010100101
1010100101
1010100101
1010100101
1111s11111